----------------------------------------------------------------------
----------------------------------------------------------------------
----------------------------------------------------------------------
----------------------------------------------------------------------
----------------------------------------------------------------------
----------------------------------------------------------------------
----------------------------------------------------------------------
----------------------------------------------------------------------
----------------------------------------------------------------------
-------------??-------------------------------------------------------
------------????------------------------------------------------------
---x-------??????-----------------------------------------------------
??????????????????????????????????????????????????????????????????????
??????????????????????????????????????????????????????????????????????