----------------------------------------------------------------------
----------------------------------------------------------------------
----------------------------------------------------------------------
----------------------------------------------------------------------
---------------------?------------------------------------------------
----------------------------------------------------------------------
----------------------------------------------------------------------
----------------------------------------------------------------------
---?---------------2?2?2----------------------------------------------
----------------------------------------------------------------------
----------------------------------------------------------------------
---m-------g----------------------------------------------------------
1111111111111111111111111111111111111111111111111111111111111111111111
1111111111111111111111111111111111111111111111111111111111111111111111